20
01100100001000100100
00000010111101000001
01000111001000000001
00100010011101010001
01100001001111000101
10000001111000000100
00010000001100100101
01100101001000001111
00100101100010111111
01100010000000000001
10011011000101101111
01101100110000100001
00000011111110010100
01111101110000100101
01010000100011000111
11000100101101010000
01100001110000000100
00001011110011000010
01111011110111010100
10000111110110001100
