10
0111100110
0001101010
1000000000
1001110001
0000001100
1111101100
0010000010
0001010110
0110001110
0100110010
